北京=北京
上海=上海
广东=东莞 河源 茂名 中山 汕尾 肇庆 惠州 韶关 汕头 潮州 湛江 佛山 阳江 江门 深圳 珠海 梅州 云浮 广州 清远 揭阳
重庆=重庆
天津=天津
浙江=杭州 宁波 舟山 绍兴 台州 金华 嘉兴 温州 湖州 丽水 衢州
福建=厦门 泉州 龙岩 南平 宁德 福州 三明 莆田 漳州
江苏=南京 泰州 徐州 常州 连云港 南通 盐城 镇江 无锡 扬州 淮安 苏州 宿迁
山东=青岛 德州 济宁 烟台 临沂 东营 威海 潍坊 滨州 淄博 日照 菏泽 泰安 莱芜 济南 聊城 枣庄
山西=太原 忻州 朔州 长治 大同 晋中 晋城 阳泉 吕梁 运城 临汾
陕西=西安 商洛 汉中 安康 榆林 咸阳 延安 铜川 渭南 宝鸡
四川=成都 广元 达州 雅安 广安 泸州 乐山 遂宁 攀枝花 南充 阿坝州 甘孜州 内江 绵阳 眉山 巴中 宜宾 西昌 自贡 德阳 资阳凉山
湖南=长沙 吉首 益阳 张家界 衡阳 邵阳 娄底 湘潭 常德 株洲 岳阳 郴州 永州 怀化
湖北=武汉 十堰 宜昌 黄冈 江汉 随州 孝感 恩施 仙桃 荆州 鄂州 黄石 襄樊 荆门 咸宁
河北=石家庄 邢台 唐山 张家口 邯郸 沧州 保定 秦皇岛 衡水 廊坊 承德
河南=郑州 洛阳 许昌 潢川 三门峡 信阳 商丘 安阳 驻马店 开封 焦作 鹤壁 周口 南阳 濮阳 漯河 新乡 平顶山
海南=海口 三亚
安徽=合肥 芜湖 巢湖 蚌埠 宣城 铜陵 池州 马鞍山 淮北 淮南 滁州 毫州 宿州 六安 黄山 安庆 阜阳
甘肃=兰州 白银 定西 甘南 嘉峪关 金昌武威 酒泉嘉峪关 临夏 陇南 平凉 庆阳 天水 武威 张掖
广西=南宁 贵港 梧州 来宾 防城港 桂林 崇左 河池 钦州 北海 玉林 柳州 百色 贺州
黑龙江=哈尔滨 牡丹江 大庆 齐齐哈尔 黑河 鸡西 绥化 七台河 双鸭山 佳木斯 伊春 鹤岗 大兴安岭
吉林=长春 四平 白城 白山 松原 延吉 梅河口 辽源 吉林 通化 珲春
辽宁=大连 本溪 丹东 铁岭 阜新 盘锦 鞍山 葫芦岛 朝阳 辽阳 营口 抚顺 沈阳 锦州
贵州=贵阳 安顺 毕节 都匀 凯里 六盘水 铜仁 兴义 遵义
江西=南昌 抚州 赣州 吉安 景德镇 九江 萍乡 上饶 新余 宜春 鹰潭
内蒙古=呼和浩特 乌兰查布 呼伦贝尔 乌兰浩特 集宁 兴安盟 鄂尔多斯 赤峰 通辽 巴彦淖尔 海拉尔 包头 乌海 阿盟 锡林浩特 临河 巴彦浩特
宁夏=银川 固原 石嘴山 吴忠 中卫
青海=西宁 德令哈 格尔木 共和 果洛 海北州 海东 海南州 海西州 海晏 黄南 玉树
云南=昆明 大理 玉溪 保山 西双版纳 曲靖 德宏 迪庆 怒江 昭通 文山 丽江 思茅 楚雄 红河 临沧
新疆=乌鲁木齐 阿克苏 阿勒泰 博乐 昌吉 哈密 和田 喀什 克拉玛依 克州 库尔勒 奎屯 石河子 塔城 吐鲁番 伊犁
西藏=拉萨 阿里 昌都 林芝 那曲 日喀则 山南
